11111111
1P1000E1
10101001
10001C01
10101001
11111110