11111111
1P0000C1
1000C011
100001C1
100E0001
10000111
11111111